vision=Видимость
movement=Передвижение
movementType=Тип передвижения
division=Дивизия
buildBy=Строится с помощью
baseDefence=Базовая броня
armorType=Тип брони
lAttack=Легкая атака
mAttack=Средняя атака
hAttack=Тяжелая атака
uAttack=Универсальная атака
ammo=Боеприпасы
attackInnerRad=Внутренний радиус атаки
attackOuterRad=Внешний радиус атаки
price=Стоимость
buildPriority=Приоритет постройки
loadCapacity=Вместимость
bounty=Награда
canBeDetected=Может быть обнаружен
canCapture=Может захватывать
canRankUp=Может быть повышен по званию
canMoveAfterBuild=Может двигаться сразу после постройки
canAttackAfterMove=Может атаковать после передвижения
canCounterAttack=Может контратаковать
canAttackFly=Может атаковать летающих юнитов
canAttackHighAir=Может атаковать высоко летающих юнитов
isHighAir=Высоко летающий
isAntiAir=Противовоздушный
canInverseLoad=Может погружать юнитов самостоятельно
canMoveAfterInverseLoad=Может двигаться после самостоятельной погрузки
canMoveAfterUnload=Может двигаться после выгрузки
canMergeWithDivision=Может объединяться с юнитами из одной дивизии, жизни распределяются по стоимости
infantryHeal=
techHeal=
shipHeal=
planeHeal=
monsterHeal=
vampireHeal=Лечит жизни в размере {0}% от нанесенного урона
mergeHeal=При объединении получает бонус в {0} жизней
killBounty=Награда в {0} монет при убийстве юнита
captureBounty=Награда в {0} монет при захвате строения
supplyHeal=При перезарядке юнитов также лечит {0} жизней
endTurnHeal=В конце хода лечится на {0} жизней
ndTurnDiseas=В конце хода теряет {0} жизней, но не может умереть от этого
afterDeathSpawnUnit=При смерти появляется {0}
repairDiscount=Скидка при лечении от строений {0}%
repairBonus=Лечится от строений дополнительно на {0} жизней
captureProgressBonus=Строения захватываются на {0}% быстрее
allySupportAttackBonus=За каждого рядом стоящего союзника получает {0}% к урону
allySupportDefenceBonus=За каждого рядом стоящего союзника получает на {0}% меньше урона
enemySupportAttackBonus=За каждого рядом стоящего врага получает {0}% к урону
enemySupportDefenceBonus=За каждого рядом стоящего врага получает на {0}% меньше урона
bloodlustAttackBonus=При неполном здоровье получает {0}% к урону
bloodlustDefenceBonus=При неполном здоровье получает на {0}% меньше урона
roadAttackBonus=Находясь на дороге получает {0}% к урону
roadDefenceBonus=Находясь на дороге получает на {0}% меньше урона
woodAttackBonus=Находясь в лесу получает {0}% к урону
woodDefenceBonus=Находясь в лесу получает на {0}% меньше урона
overallAttackBonus=Получает {0}% к урону
overallDefenceBonus=Получает на {0}% меньше урона
infantryAttackBonus=При атаке пехоты получает {0}% к урону
infantryDefenceBonus=Получает на {0}% меньше урона от пехоты
techAttackBonus=При атаке наземной техники получает {0}% к урону
techDefenceBonus=Получает на {0}% меньше урона от наземной техники 
hipAttackBonu=
hipDefenceBonu=
planeAttackBonus=При атаке воздушной техники получает {0}% к урону
planeDefenceBonus=Получает на {0}% меньше урона от воздушной техники
monsterAttackBonus=
monsterDefenceBonus=
passedCellsAttackBonus=За каждую пройденную клетку перед атакой получает {0}% к урону
passedCellsDefenceBonus=За каждую пройденную клетку перед атакой получает на {0}% меньше урона
ammoAfterKillBonus=Получает {0} боеприпасов при убийстве юнита
passedCellsVampireBonus=Лечит жизни в размере {0}% от урона за каждую пройденную клетку перед атакой
counterAttackBonus=При контратаке получает {0}% к урону
counterDefenceBonus=При контратаке получает на {0}% меньше урона
attackCount=Может атаковать за ход {1+0} раза
attackSeparateFromMove=Атакует вне зависимости от передвижения
moveFullMovement=Может передвигаться несколько раз
canMoveAfterAttack=Может передвигаться после атаки
refreshMoveAfterKill=После убийства может ходить снова
lastTurnMovedAttackBonus=Если ходил в прошлый ход, получает {0}% к урону
lastTurnAttackedAttackBonus=Если атаковал в прошлый ход, получает {0}% к урону
lastTurnAttackedDefendBonus=Если атаковал в прошлый ход, получает на {0}% меньше урона
lastTurnAttackedMovementBonus=Если атаковал в прошлый ход, получает дополнительно {0} передвижения
lastTurnNotAttackedAttackBonus=Если не атаковал в прошлый ход, получает {0}% к урону
lastTurnNotAttackedMovementBonus=Если не атаковал в прошлый ход, получает дополнительно {0} передвижения
fullHpAttackBonus=При полном здоровье получает {0}% к урону
fullHpDefenceBonus=При полном здоровье получает на {0}% меньше урона
hpOfSpawnUnit=При появлении юнита после смерти, у него будет {0} жизней
maxDamageTaken=Не может получить больше чем {0} урона за раз
maxDamageGiven=Не может нанести больше чем {0} урона за раз
baseDefenceIgnorePercent=Игнорирует {0}% базовой брони у противника
landscapeDefenceIgnorePercent=Игнорирует {0}% бонуса к броне от ландшафта у противника
ingleAllySupportAttackBonu=Если рядом находится союзник, получает {0}% к урону
ingleAllySupportDefenceBonu=Если рядом находится союзник, получает на {0}% меньше урона
rockAttackBonus=Находясь в горах получает {0}% к урону
rockDefenceBonus=Находясь в горах получает на {0}% меньше урона
buildingAttackBonus=Находясь в строениях получает {0}% к урону
buildingDefenceBonus=Находясь в строениях получает на {0}% меньше урона
ignoreRockDefence=Игнорирует бонус к броне от гор у противника
ignoreBuildingDefence=Игнорирует бонус к броне от строений у противника
isIndirect=Является артиллерией
indirectAttackBonus=При атаке артиллерии получает {0}% к урону
indirectDefenceBonus=Получает на {0}% меньше урона от артиллерии 
attackFirstAttackBonus=Если атаковал первым получает {0}% к урону
attackFirstDefenceBonus=Если атаковал первым получает на {0}% меньше урона
ignoreOverallDefenceBonus=Игнорирует {0}% от базовой брони и бонуса брони от ландшафта
healAfterKillBonus=Лечение {0} жизней при убийстве юнита
thisTurnSuppliedAttackBonus=После перезарядки юниты получают {0}% к урону до следующего хода
thisTurnSuppliedDefenceBonus=После перезарядки юниты получают на {0}% меньше урона до следующего хода
afterDeathSpawnLoadedUnit=При смерти погруженный юнит остается жив
transportedHeal=Лечение {0} жизней у погруженного юнита в начале хода
transportedDisease=Погруженный юнит теряет {0} жизней в начале хода
moveRankBonus=За каждый ранг получает дополнительно {0} передвижения
attackRankBonus=За каждый ранг получает получает {0}% к урону
defenceRankBonus=За каждый ранг получает получает на {0}% меньше урона
rockOuterRadBonus=На горе имеет дополнительно {0} клеток радиуса атаки
attackNotFullHpEnemyBonus=При атаке врагов с неполным здоровьем получает {0}% к урону
attackEnemyOnBuildingBonus=При атаке врагов в строениях получает {0}% к урону
unloadedMovementBonus=После выгрузки юнит получает дополнительно {0} передвижения
unloadedAttackBonus=После выгрузки юнит получает {0}% к урону
unloadedDefenceBonus=После выгрузки юнит получает на {0}% меньше урона
canBorrowAmmoAlly=Если закончились боеприпасы, то берет их у ближайшего союзника
canLoadTech=Может перевозить наземную технику
destroyEnemyAmmo=После атаки уничтожает у врага {0} боеприпасов
fullAmmoAttackBonus=При полных боеприпасах получает {0}% к урону
fullAmmoDefenceBonus=При полных боеприпасах получает на {0}% меньше урона
